あ	a
か	ka
さ	sa
た	ta
な	na
は	ha
ま	ma
や	ya
ら	ra
わ	wa
ん	n
い	i
き	ki
し	shi
ち	chi
に	ni
ひ	hi
み	mi
ゆ	yu
り	ri
を	o
う	u
く	ku
す	su
つ	tsu
ぬ	nu
ふ	fu
む	mu
よ	yo
る	ru
え	e
け	ke
せ	se
て	te
ね	ne
へ	he
め	me
れ	re
お	o
こ	ko
そ	so
と	to
の	no
ほ	ho
も	mo
ろ	ro
